0/00_2/23_1/00_0/00_0/00_0/00_0/09_0/00_0/00_0/00_0/00_2/21_1/00_0/00_0/00_2/15_1/00_0/00_0/00_0/00_
4/00_5/00_5/00_4/06_4/00_4/00_4/08_4/00_4/00_4/00_4/11_5/00_5/00_0/00_0/00_2/00_1/00_0/00_0/00_0/00_
3/20_5/00_5/00_3/11_3/00_3/00_3/08_3/00_3/00_3/00_3/06_5/00_5/00_0/00_0/00_2/06_1/10_0/00_0/00_0/00_
0/00_2/06_1/06_0/00_0/00_0/00_0/00_0/00_0/00_0/00_0/00_2/00_1/06_0/00_0/00_5/00_5/00_4/06_4/00_4/18_
0/00_5/00_5/00_4/06_4/00_4/00_4/00_4/00_5/00_0/00_0/00_2/00_1/00_0/00_0/00_5/00_5/00_3/00_3/00_3/00_
0/00_5/00_5/00_3/12_3/00_3/00_3/00_3/06_5/00_0/00_0/00_2/08_1/08_0/00_0/00_2/00_1/06_0/00_0/00_0/00_
0/00_2/00_1/06_0/00_0/00_0/00_0/00_0/00_0/00_0/00_0/00_2/00_1/00_0/00_0/00_2/08_1/08_0/09_0/00_0/00_
0/00_2/06_1/00_0/00_0/00_0/00_0/00_0/00_0/09_0/00_0/00_2/06_1/00_0/00_0/00_2/00_1/00_0/00_0/00_0/00_
4/00_5/00_5/00_4/06_5/00_5/00_4/06_4/00_4/08_4/00_4/00_5/00_5/00_4/06_4/00_5/00_5/00_4/06_4/00_4/22_
3/17_5/00_5/00_3/00_5/00_5/00_3/00_3/00_3/08_3/00_3/06_5/00_5/00_3/00_3/06_5/00_5/00_3/00_3/00_3/00_
0/00_0/00_0/00_0/00_2/00_1/06_0/00_0/00_0/00_0/00_0/00_0/00_0/00_0/00_0/00_2/00_1/06_0/00_0/00_0/00_
0/00_0/00_0/00_0/00_2/00_1/00_0/00_0/00_5/00_5/00_0/00_0/00_0/00_0/00_0/00_2/00_1/00_0/00_0/00_0/00_
0/00_0/00_0/00_0/00_2/06_1/00_0/00_0/00_2/06_1/06_0/00_5/00_4/06_4/00_4/11_5/00_5/00_4/06_4/00_4/14_
4/00_5/00_5/00_4/00_5/00_5/00_4/06_4/00_5/00_5/00_0/00_5/00_3/00_3/00_3/06_5/00_5/00_3/10_3/00_3/00_
3/24_5/00_5/00_3/06_5/00_5/00_3/00_3/00_5/00_5/00_0/00_0/00_0/00_0/00_0/00_2/00_1/06_0/00_0/00_0/00_
0/00_2/00_1/06_0/00_2/10_1/06_0/00_0/00_2/00_1/00_0/00_0/00_0/00_0/00_0/00_2/00_1/00_0/00_0/00_0/00_
0/00_2/00_1/00_0/00_2/00_1/00_0/00_0/00_2/06_1/00_0/00_0/00_0/09_0/00_0/00_2/06_1/00_0/00_0/00_0/00_
4/00_5/00_5/00_0/00_2/08_1/08_0/09_0/00_5/00_5/00_4/06_4/00_4/08_4/00_4/12_5/00_5/00_4/06_4/00_4/25_
3/06_5/00_5/13_0/00_2/00_1/00_0/00_0/00_5/00_5/00_3/12_3/00_3/08_3/00_3/06_5/00_5/00_3/00_3/00_3/00_
0/00_0/00_0/00_0/00_2/00_1/16_0/00_0/00_0/00_0/00_0/00_0/00_0/00_0/00_0/00_2/00_1/19_0/00_0/00_0/00_
