15_0,1
15_1,1
15_2,1
15_3,1
15_4,1
15_5,1
15_6,1
15_7,1
15_8,1
15_9,1
15_10,1
15_11,1
15_12,1
15_13,1
15_14,1
15_15,1
15_16,1
15_17,1
15_18,1
15_19,1
