0/00_2/06_1/00_0/00_0/00_0/00_0/09_0/00_0/00_0/00_0/00_2/06_1/00_0/00_0/00_2/00_1/00_0/00_0/00_0/00_
4/00_5/00_5/00_4/06_4/00_4/00_4/08_4/00_4/00_4/00_4/11_5/00_5/00_0/00_0/00_2/00_1/00_0/00_0/00_0/00_
3/06_5/00_5/00_3/11_3/00_3/00_3/08_3/00_3/00_3/00_3/06_5/00_5/00_0/00_0/00_2/06_1/10_0/00_0/00_0/00_
0/00_2/06_1/06_0/00_0/00_0/00_0/00_0/00_0/00_0/00_0/00_2/00_1/06_0/00_0/00_5/00_5/00_4/06_4/00_4/00_
0/00_5/00_5/00_4/06_4/00_4/00_4/00_4/00_5/00_0/00_0/00_2/00_1/00_0/00_0/00_5/00_5/00_3/00_3/00_3/00_
0/00_5/00_5/00_3/12_3/00_3/00_3/00_3/06_5/00_0/00_0/00_2/08_1/08_0/00_0/00_2/00_1/06_0/00_0/00_0/00_
0/00_2/00_1/06_0/00_0/00_0/00_0/00_0/00_0/00_0/00_0/00_2/00_1/00_0/00_0/00_2/08_1/08_0/09_0/00_0/00_
0/00_2/06_1/00_0/00_0/00_0/00_0/00_0/00_0/09_0/00_0/00_2/06_1/00_0/00_0/00_2/00_1/00_0/00_0/00_0/00_
4/00_5/00_5/00_4/06_5/00_5/00_4/06_4/00_4/08_4/00_4/00_5/00_5/00_4/06_4/00_5/00_5/00_4/06_4/00_4/00_
3/06_5/00_5/00_3/00_5/00_5/00_3/00_3/00_3/08_3/00_3/06_5/00_5/00_3/00_3/06_5/00_5/00_3/00_3/00_3/00_
0/00_0/00_0/00_0/00_2/00_1/06_0/00_0/00_0/00_0/00_0/00_0/00_0/00_0/00_0/00_2/00_1/06_0/00_0/00_0/00_
0/00_0/00_0/00_0/00_2/00_1/00_0/00_0/00_5/00_5/00_0/00_0/00_0/00_0/00_0/00_2/00_1/00_0/00_0/00_0/00_
0/00_0/00_0/00_0/00_2/06_1/00_0/00_0/00_2/06_1/06_0/00_5/00_4/06_4/00_4/11_5/00_5/00_4/06_4/00_4/00_
4/00_5/00_5/00_4/00_5/00_5/00_4/06_4/00_5/00_5/00_0/00_5/00_3/00_3/00_3/06_5/00_5/00_3/10_3/00_3/00_
3/00_5/00_5/00_3/06_5/00_5/00_3/00_3/00_5/00_5/00_0/00_0/00_0/00_0/00_0/00_2/00_1/06_0/00_0/00_0/00_
0/00_2/00_1/06_0/00_2/10_1/06_0/00_0/00_2/00_1/00_0/00_0/00_0/00_0/00_0/00_2/00_1/00_0/00_0/00_0/00_
0/00_2/00_1/00_0/00_2/00_1/00_0/00_0/00_2/06_1/00_0/00_0/00_0/09_0/00_0/00_2/06_1/00_0/00_0/00_0/00_
4/00_5/00_5/00_0/00_2/08_1/08_0/09_0/00_5/00_5/00_4/06_4/00_4/08_4/00_4/12_5/00_5/00_4/06_4/00_4/00_
3/06_5/00_5/00_0/00_2/00_1/00_0/00_0/00_5/00_5/00_3/12_3/00_3/08_3/00_3/06_5/00_5/00_3/00_3/00_3/00_
0/00_0/00_0/00_0/00_2/00_1/00_0/00_0/00_0/00_0/00_0/00_0/00_0/00_0/00_0/00_2/00_1/06_0/00_0/00_0/00_
